{
    "1": [["X", "X", "X", "X", "X", "X", "X", "X", "X", "X", "X", "X", "X", "X", "X", "X", "X", "X", "X", "X"],
          ["X", "S", "S", "X", "X", "X", "X", "X", "X", "X", "X", "X", "X", "X", "X", "X", "X", "X", "X", "X"],
          ["X", " ", " ", " ", "X", "X", "X", "X", "X", " ", " ", " ", " ", " ", " ", "X", "X", "X", "X", "X"],
          ["X", " ", " ", " ", "X", "X", "X", "X", " ", " ", " ", " ", " ", " ", " ", " ", "X", "X", "X", "X"],
          ["X", "X", " ", " ", " ", " ", "X", "X", " ", " ", " ", "X", "X", " ", " ", " ", " ", " ", "X", "X"],
          ["X", "X", " ", " ", " ", " ", "X", "X", " ", " ", "X", "X", "X", "X", " ", " ", "E", "E", "X", "X"],
          ["X", "X", "X", "X", " ", "_", "_", "_", "_", " ", "X", "X", "X", "X", "X", "X", "E", "E", "X", "X"],
          ["X", "X", "X", "X", " ", "_", "_", "_", "_", " ", "X", "X", "X", "X", "X", "X", "E", "E", "X", "X"],
          ["X", "X", "X", "X", "X", "X", "X", "X", "X", "X", "X", "X", "X", "X", "X", "X", "E", "E", "X", "X"],
          ["X", "X", "X", "X", "X", "X", "X", "X", "X", "X", "X", "X", "X", "X", "X", "X", "E", "E", "X", "X"],
          ["X", "X", "X", "X", "X", "X", "X", "X", "X", "X", "X", "X", "X", "X", "X", " ", "E", "E", "X", "X"],
          ["X", "X", "X", "X", "X", "X", "X", "X", "X", " ", " ", " ", " ", " ", " ", " ", " ", " ", "X", "X"],
          ["X", "X", " ", " ", " ", " ", " ", "X", "X", " ", " ", " ", " ", " ", " ", " ", " ", "X", "X", "X"],
          ["X", "X", " ", " ", " ", " ", " ", " ", "X", " ", " ", "X", "X", "X", "X", "X", "X", "X", "X", "X"],
          ["X", "X", " ", " ", "X", " ", "E", "E", "E", "E", " ", "X", "X", "X", "X", "X", "X", "X", "X", "X"],
          ["X", "X", " ", " ", "X", "X", "E", "E", "E", "E", " ", "X", "X", "X", "X", "X", "X", "X", "X", "X"],
          ["X", "X", " ", " ", " ", "X", "X", "X", "X", "X", "X", "X", "X", " ", " ", " ", " ", "F", "F", "X"],
          ["X", "X", " ", " ", " ", " ", " ", " ", " ", " ", " ", " ", " ", " ", " ", " ", " ", "F", "F", "X"],
          ["X", "X", "X", " ", " ", " ", " ", " ", " ", " ", " ", " ", " ", " ", " ", "X", "X", "X", "X", "X"],
          ["X", "X", "X", "X", "X", "X", "X", "X", "X", "X", "X", "X", "X", "X", "X", "X", "X", "X", "X", "X"]]
}